Date,Transaction type,Description,Paid out,Paid in,Balance
01 Dec 2017,Visa purchase,AMAZON,16.98,,414.01
01 Dec 2017,Contactless Payment,BLOOMSBURY BOWLING,1.00,,413.01
02 Dec 2017,Contactless Payment,BLOOMSBURY BOWLING,3.50,,409.51
02 Dec 2017,Contactless Payment,THE GOAT,25.05,,384.46
02 Dec 2017,Contactless Payment,T K MAXX,26.98,,357.48
02 Dec 2017,Contactless Payment,THE GOAT,30.80,,326.68
04 Dec 2017,Contactless Payment,MARKS&SPENCER,0.20,,326.48
